1111111111111111111111
1P10001000100000000001
1010101010100000000001
10101010101000C0000001
10001000100000000000E1
1111111111111111111111